WWWWWWWWWWWWWWWWWWWWWWWWWWWWWWWWWWWWWWWWWWWWWWWWWWWWWWWWWWWWWWWWWWWWWWWWWWWWWWWWWWWWWWWWWWWWWWWWWWWWWWWWWWWWWWWWWWWWWWWWWWWWWWWWWWWWWWWWWWWWWWWWWWWWWWWWWWWWWWWW
W--------------------------------------------------------------------------------------------------------------------------------------------------------------W
W--------------------------------------------------------------------------------------------------------------------------------------------------------------W
WS-----SSSSSSSSSSSSSSSSSSSSSSSSSSSSSSSSSSSSSSSSSSSSSSSSSSSSSSSSSSSSSSSSSSSSSSSSSSSSSSSSSSS?SSSSSSSSSSSSSSSSSSSSSSSSSSSSSSSSSSSSSSSSSSSSSSSS--------------------W
WS-----------------------------------------------------SS--SSSSSS--SSSS------SSSS------------------------------------------------------------------------------W
WS-----------------------------------------------------SS--SSSSSS--SSSS--E---SSSS------------------------------------------------------------XXX-------------!-W
WS----------------------------------------oooo-------SS--------SS---S----SS----------oooooo-----------------------------------------------------------------XXXW
WS-----------------------------o---------------------SS--------SS---S----SS------------------------------------------------------------------------------------W
WS--------------------------------------S-SSSS-S-----SS--------SS---S----SS----------SSSSSS--------------------------------------------------------------------W
WS----------------------------S---------SoS--SoS-----SS----ooooSS---So??-SS---E------SSSSSS--------------------E----------------------------------SSSSS??------W
WS---------QQQQQ--------XXXX------------SSS--SSS-----SSSS--SSSSSS---SSS--SS--SSSS------------------------E----<>-------------------------XXX-------------------W
WS--------------------XXXXXXXX--XX---------------------SS-------------------EE--------------------------<>----[]-----E-----SS-----------EXXX-XXX---------------W
WS------------------XXXXXXXXXX--XXXX-------------------SS-----------------------------------------------[]----[]----<>-----SS---------EXXXXX-------------------W
WS---*---------EE-XXXXXXXXXXXXE-XXXX-------EE---------E------E--E--------------------------------E-EE---[]----[]--E-[]-----SS---------XXXXXX---------E---------W
WXXXXXXXXXXXXXXXXXXXXXXXXXXXXXXXXXXXXXXXXXXXXXXXXXXXXXXXXXXXXXXXXXXXXXXXXXXXXXXXXHHHXXXXXXXXXXXXXXXXXXXXXXXXXXXXXXXXXXXXXHHXXHHXXXXXXXXXXXXHHHHHHHXXXXXXXXHHXXXW
WWWWWWWWWWWWWWWWWWWWWWWWWWWWWWWWWWWWWWWWWWWWWWWWWWWWWWWWWWWWWWWWWWWWWWWWWWWWWWWWWWWWWWWWWWWWWWWWWWWWWWWWWWWWWWWWWWWWWWWWWWWWWWWWWWWWWWWWWWWWWWWWWWWWWWWWWWWWWWWW