------------------------------------------------------------------------------------------------------------------------------------------------------------------------------------------------------
------------------------------------------------------------------------------------------------------------------------------------------------------------------------------------------------------
------------------------------------------------------------------------------------------------------------------------------------------------------------------------------------------------------
--------------------------------------------------------------------------------------------------------------------------------------------------------------------------------------------------!---
--------------------------------------------------------------------------------------------------------------------------------------------------------------------------------------------------!---
-------------------------------------------------------------------------------------B*B------------------------------------------------------------------------------------------------##--------!---
-------------------------------------------------------------------------------------------------------------------------------------------------------V--------------------------------##--------!---
-------------------------------------------------------------------------------------------------------------------------------------------------------[]-------------------------------##--------!---
-------------------------------------------------------------------------------------------------------------------------------------------------------pP----------------------------#--##--------!---
---------------------------------------V------V-------------------------------------#####-----------------------------------------------------#+BB-----##---------------------------##--##--------!---
---------------------------------------[]-----[]----K--------------------------K----#--------------------------#------------------------------#---------------V------------K----K--###--##--------!---
---------------------------------------pP-----pP------------------------------------#---------------------C----#------------------------------#-----------C---[]-----C------------####------------!---
----------k--g-gg-------gg-g-----k-----pP-----pP-----------ggg------gg-g------------#-------------gg-g----c----#---gg-g--k------g----------k-k#-----------c---pP-----c-----------#####------------#---
############################################--#########################################----##################--####################################---################################################
