WWWWWWWWWWWWWWWWWWWWWWWWWWWWWWWWWWWWWWWWWWWWWWWWWWWWWWWWWWWWWWWWWWWWWWWWWWWWWWWWWWWWWWWWWWWWWWWWWWWWWWWWWWWWWWWWWWWWWWWWWWWWWWWWWWWWWWWWWWWWWWWWWWWWWWWW
W------------------------------------------------------------------------------------------------------------------------------------------------------W
W------------------------------------------------------------------------------------------------------------------------------------------------------W
W------------------------------------------------------------------------------------------------------------------------------------------------------W
W------------------------------------------------------------------------------------------------------------------------------------------------------W
W-----------------------------------XXXXXXX------------------------------------------------------------------------------------------------------------W
W---------------------XXXXX-----------------------------XXXX------------------------------------------------------------------------------XX-----------W
W-----------------------------------------------------------------------XXXXXX----------------------------------------------XXX-----------XX-----------W
W---------------------------------------------------------------------------------------------------XXXXXXXX----------------------------XXXX-----------W
W------------------------------XXXXX----------------------------------------------XXX---------------------------------------------------XXXX-----------W
W-------------------XXXXXXXX--------------------------------------XXX---------------------XXX-------------------XXXX--XXXX------------XXXXXX-----------W
W--------------------------------------------------XXXX?------------------------------------------------------------------------------XXXXXX-----------W
W---------------------------------------------------------------------------------------------XXXX------------------------------------XXXXXX-----------W
W---*---------XXXX----------XXX-------------------------------------------------------------------------------------------------------XXXXXX--------!--W
WXXXXXXXXXXX----------------------------------XXXX-----XXXXX-XXXXX-------------------------------------------XXX-------------XXXXXXXXXXXXXXXXXXXXXXXXXXW
WXXXXXXXXXXXHHHHHHHHHHHHHHHHHHHHHHHHHHHHHHHHHHXXXXHHHHHXXXXXHXXXXXHHHHHHHHHHHHHHHHHHHHHHHHHHHHHHHHHHHHHHHHHHHXXXHHHHHHHHHHHHHXXXXXXXXXXXXXXXXXXXXXXXXXXW
WWWWWWWWWWWWWWWWWWWWWWWWWWWWWWWWWWWWWWWWWWWWWWWWWWWWWWWWWWWWWWWWWWWWWWWWWWWWWWWWWWWWWWWWWWWWWWWWWWWWWWWWWWWWWWWWWWWWWWWWWWWWWWWWWWWWWWWWWWWWWWWWWWWWWWWW
