-------------------------------------------------------------------------------------------------------------------------------------------------------------------------------------------------------------------------
-------------------------------------------------------------------------------------------------------------------------------------------------------------------------------------------------------------------------
-------------------------------------------------------------------------------------------------------------------------------------------------------------------------------------------------------------------------
-------------------------------------------------------------------------------------------------------------------------------------------------------------------------------------------------------------------------
-------------------------------------------------------------------------------------------------------------------------------------------------------------------------------------------------------------------------
-----------------------------------------------------------BBBBBBMB-----------------------------------------------BMBBBBBB---------------------------------------------------------------------------------##--------!---
---------------------------------------------------------------------------------------------------------------------------------------------------------------------------------------------------------------------!---
---------------------------------------------------------------------------------------------------------------------------------------------------------------------------------------------------------#-----------!---
----------------------------------------------------V----------h-------------------------------------------------------h-----V---------------------------------------------------------------------------------------!---
----------------------------------------------------[]-----BBBBBBBB---#-------------------------------------##----BBBBBBBB---[]-----------------------------------------V--------------------O---------#-------------!---
---------------------------------C------------------pP----------------##----------------------#-------------##---------------pP-----------------------------------------[]-------------------------------------------!---
-----------------C---------K-----c------------------pP----------------###------------C----K---#-------------##---------------pP---------------------------------h-------pP------------------------#--#---------------!---
-----------------c---------------c------------------pP------------h---####-----------c--------#-------------##-------h-------pP--------k---------h----------------------pP-------h-------h--------#------------------#---
####################################################################--####--###############################################--##--###################################################################-----------##########
