--------------------------
-------------Q------------
--------------------------
--------------------------
--------------------------
-------Q---S?S?S----------
--------------------------
--------------------------
*------------------------!
XXXXXXXXXXXXXXXXXXXXXXXXXX
