----------------------------------------------------------------------------------------------------------------------------------------------------------------------------------------------------------
----------------------------------------------------------------------------------------------------------------------------------------------------------------------------------------------------------
----------------------------------------------------------------------------------------------------------------------------------------------------------------------------------------------------------
----------------------------------------------------------------------------------------------------------------------------------------------------------------------------------------------------------
----------------------------------------------------------------------------------g-----------------------------------------------------------------------------------------------------------------------
----------------------?---------------------------------------------------------BBBBBBBB---BBB?--------------M-----------BBB----B??B--------------------------------------------------------##------------
-------------------------------------------------------------------------------------------------------------------------------------------------------------------------------------------###------------
-------------------------------------------------------------------------------g----------------------------------------------------------------------------------------------------------####------------
----------------------------------------------------------------+------------------------------------------------------------------------------------------------------------------------#####------------
----------------?---BMB?B---------------------[]---------[]------------------BMB--------------O-----B*----?--?--?-----B----------BB------#--#----------##--#------------BB?B------------######------------
--------------------------------------[]------pP---------pP-----------------------------------------------------------------------------##--##--------###--##--------------------------#######------------
----------------------------[]--------pP------pP---------pP----------------------------------------------------------------------------###--###------####--###-----[]--------------[]-########--------!---
S--------------------g------pP--------pP-g----pP-----gg--pP------------------------------------gg---------k-----------------gg-gg-----####--####----#####--####----pP---------gg---pP#########--------#---
#####################################################################--###############---#################################################################################################################
