XXXXXXXXXXXXXXXXXXXXXXXXXXXXXXXXXXXXXXXXXXXXXXXXXXXXXXXXXXXXXXXXXXXXXXXXXXXXXXXXXXXXXXXXXXXXXXXXXXXXXXXXXXXXXXXXXXXXXXXXXXXXXXXXXXXXXXXXXXXXXXXXXXXXXXXX
X------------------------------------------------------------------------------------------------------------------------------------------------------X
X------------------------------------------------------------------------------------------------------------------------------------------------------X
X--------------------------------oo--------------------------------------------------------------------------------------------------------------------X
X------------------------------------E--E--------------------------------------------------------------------------------------------------------------X
X---------------------Eooo----------XXXXXXX-------------oooo----------E------------------oo--oo--------------------------------------------------------X
X---------------------XXXXX-----------------------------XXXX----------E--E-------oo---------------------------E-----oo--------------------XX-----------X
X---------------------------------------------oo------------------------XXXXXX------------------------E---------------------XXX-----------XX-----------X
X---------------------------------------------------------------------------------------------------XXXXXXXX----------------------------XXXX-----------X
X------------------------------XXXXX----------------------------------------------XXX---------------------------------------------------XXXX-----------X
X-------------------XXXXXXXX--------------------------------------XXX---------------------XXX-------------------XXXX--XXXX------------XXXXXX-----------X
X--------------------------------------------------XXXX?------------------------------------------------------------------------------XXXXXX-----------X
X----------------------------o----------------------------------------------------------------XXXX------------------------------------XXXXXX-----------X
X---*---------XXXX----------XXX------------------------------------------------------------------------------ooo------------------E---XXXXXX--------!--X
XXXXXXXXXXXXHHHHHHHHHHHHHHHHHHHHHHHHHHHHHHHHHHXXXXHHHHHXXXXXHXXXXXHHHHHHHHHHHHHHHHHHHHHHHHHHHHHHHHHHHHHHHHHHHXXXHHHHHHHHHHHHHXXXXXXXXXXXXXXXXXXXXXXXXXXX
