-------------------
-------------Q-----
-------------------
-------------------
-------------------
-------Q---S?SQS---
-------------------
-------------------
*-----------E---!--
XXXXXXXXXXXXXXXXXXX
