WWWWWWWWWWWWWWWWWWWWWWWWWWWWWWWWWWWWWWWWWWWWWWWWWWWWWWWWWWWWWWWWWWWWWWWWWWWWWWWWWWWWWWWWWWWWWWWWWWWWWWWWWWWWWWWWWWWWWWWWWWWWWWWWWWWWWWWWWWWWWWWWWWWWWWWWWWWWWWWWWWWWWWWWWWWWWWWWWWWWWWWWWWWWWWWWWWWWWWWWWWWW
W----------------------------------------------------------------------------------------------------------------------------------------------------------------------------------------------------------W
W----------------------------------------------------------------------------------------------------------------------------------------------------------------------------------------------------------W
W----------------------------------------------------------------------------------------------------------------------------------------------------------------------------------------------------------W
W----------------------------------------------------------------------------------------------------------------------------------------------------------------------------------------------------------W
W----------------------------------------------------------------------------------E-----------------------------------------------------------------------------------------------------------------------W
W----------------------Q---------------------------------------------------------SSSSSSSS---SSSQ--------------?-----------SSS----SQQS--------------------------------------------------------XX------------W
W-------------------------------------------------------------------------------------------------------------------------------------------------------------------------------------------XXX------------W
W-------------------------------------------------------------------------------E----------------------------------------------------------------------------------------------------------XXXX------------W
W----------------------------------------------------------------S------------------------------------------------------------------------------------------------------------------------XXXXX------------W
W----------------Q---S?SQS---------------------<>---------<>------------------S?S--------------S-----SS----Q--Q--Q-----S----------SS------X--X----------XX--X------------SSQS------------XXXXXX------------W
W--------------------------------------<>------[]---------[]-----------------------------------------------------------------------------XX--XX--------XXX--XX--------------------------XXXXXXX------------W
W----------------------------<>--------[]------[]---------[]----------------------------------------------------------------------------XXX--XXX------XXXX--XXX-----<>--------------<>-XXXXXXXX------------W
W---*-----------------E------[]--------[]-E----[]-----E-E-[]------------------------------------E-E--------E-----------------EE-E-E----XXXX--XXXX----XXXXX--XXXX----[]---------EE---[]XXXXXXXXX--------!---W
WXXXXXXXXXXXXXXXXXXXXXXXXXXXXXXXXXXXXXXXXXXXXXXXXXXXXXXXXXXXXXXXXXXXXX--XXXXXXXXXXXXXXX---XXXXXXXXXXXXXXXXXXXXXXXXXXXXXXXXXXXXXXXXXXXXXXXXXXXXXXXXXXXXXXXX--XXXXXXXXXXXXXXXXXXXXXXXXXXXXXXXXXXXXXXXXXXXXXXXW
WXXXXXXXXXXXXXXXXXXXXXXXXXXXXXXXXXXXXXXXXXXXXXXXXXXXXXXXXXXXXXXXXXXXXXHHXXXXXXXXXXXXXXXHHHXXXXXXXXXXXXXXXXXXXXXXXXXXXXXXXXXXXXXXXXXXXXXXXXXXXXXXXXXXXXXXXXHHXXXXXXXXXXXXXXXXXXXXXXXXXXXXXXXXXXXXXXXXXXXXXXXW
WWWWWWWWWWWWWWWWWWWWWWWWWWWWWWWWWWWWWWWWWWWWWWWWWWWWWWWWWWWWWWWWWWWWWWWWWWWWWWWWWWWWWWWWWWWWWWWWWWWWWWWWWWWWWWWWWWWWWWWWWWWWWWWWWWWWWWWWWWWWWWWWWWWWWWWWWWWWWWWWWWWWWWWWWWWWWWWWWWWWWWWWWWWWWWWWWWWWWWWWWWWW
