-------------------
-------------------
-------------------
-------------------
---------------XXX-
-------------------
---XX?X---XX-------
----------XX-------
*---------XX----!--
XXXXXXXXXXXXXXXXXXX
