XXXXXXXXXXXXXXXXXXXXXXXXXXXXXXXXXXXXXXXXXXXXXXXXXXXXXXXXXXXXXXXXXXXXXXXXXXXXXXXXXXXXXXXXXXXXXXXXXXXXXXXXXXXXXXXXXXXXXXXXXXXXXXXXXXXXXXXXXXXXXXXXXXXXXXXXXXXXXXXX
X--------------------------------------------------------------------------------------------------------------------------------------------------------------X
X--------------------------------------------------------------------------------------------------------------------------------------------------------------X
XS-----SSSSSSSSSSSSSSSSSSSSSSSSSSSSSSSSSSSSSSSSSSSSSSSSSSSSSSSSSSSSSSSSSSSSSSSSSSSSSSSSSSS?SSSSSSSSSSSSSSSSSSSSSSSSSSSSSSSSSSSSSSSSSSSSSSSS--------------------X
XS-----------------------------------------------------SS--SSSSSS--SSSS------SSSS------------------------------------------------------------------------------X
XS-----------------------------------------------------SS--SSSSSS--SSSS--E---SSSS------------------------------------------------------------XXX-------------!-X
XS----------------------------------------oooo-------SS--------SS---S----SS----------oooooo-----------------------------------------------------------------XXXX
XS-----------------------------o---------------------SS--------SS---S----SS------------------------------------------------------------------------------------X
XS--------------------------------------S-SSSS-S-----SS--------SS---S----SS----------SSSSSS--------------------------------------------------------------------X
XS----------------------------S---------SoS--SoS-----SS----ooooSS---So??-SS---E------SSSSSS--------------------E----------------------------------SSSSS??------X
XS---------QQQQQ--------XXXX------------SSS--SSS-----SSSS--SSSSSS---SSS--SS--SSSS------------------------E----<>-------------------------XXX-------------------X
XS--------------------XXXXXXXX--XX---------------------SS-------------------EE--------------------------<>----[]-----E-----SS-----------EXXX-XXX---------------X
XS------------------XXXXXXXXXX--XXXX-------------------SS-----------------------------------------------[]----[]----<>-----SS---------EXXXXX-------------------X
XS---*---------EE-XXXXXXXXXXXXE-XXXX-------EE---------E------E--E--------------------------------E-EE---[]----[]--E-[]-----SS---------XXXXXX---------E---------X
XXXXXXXXXXXXXXXXXXXXXXXXXXXXXXXXXXXXXXXXXXXXXXXXXXXXXXXXXXXXXXXXXXXXXXXXXXXXXXXXXHHHXXXXXXXXXXXXXXXXXXXXXXXXXXXXXXXXXXXXXHHXXHHXXXXXXXXXXXXHHHHHHHXXXXXXXXHHXXXX