WWWWWWWWWWWWWWWWWWWWWWWWWWWWWWWWWWWWWWWWWWWWWWWWWWWWWWWWWWWWWWWWWWWWWWWWWWWWWWWWWWWWWWWWWWWWWWWWWWWWWWWWWWWWWWWWWWWWWWWWWWWWWWWWWWWWWWWWWWWWWWWWWWWWWWWW
W------------------------------------------------------------------------------------------------------------------------------------------------------W
W------------------------------------------------------------------------------------------------------------------------------------------------------W
W--------------------------------oo--------------------------------------------------------------------------------------------------------------------W
W------------------------------------E--E--------------------------------------------------------------------------------------------------------------W
W---------------------Eooo----------XXXXXXX-------------oooo----------E------------------oo--oo--------------------------------------------------------W
W---------------------XXXXX-----------------------------XXXX----------E--E-------oo---------------------------E-----oo--------------------XX-----------W
W---------------------------------------------oo------------------------XXXXXX------------------------E---------------------XXX-----------XX-----------W
W---------------------------------------------------------------------------------------------------XXXXXXXX----------------------------XXXX-----------W
W------------------------------XXXXX----------------------------------------------XXX---------------------------------------------------XXXX-----------W
W-------------------XXXXXXXX--------------------------------------XXX---------------------XXX-------------------XXXX--XXXX------------XXXXXX-----------W
W--------------------------------------------------XXXX?------------------------------------------------------------------------------XXXXXX-----------W
W----------------------------o----------------------------------------------------------------XXXX------------------------------------XXXXXX-----------W
W---*---------XXXX----------XXX------------------------------------------------------------------------------ooo------------------E---XXXXXX--------!--W
WXXXXXXXXXXXHHHHHHHHHHHHHHHHHHHHHHHHHHHHHHHHHHXXXXHHHHHXXXXXHXXXXXHHHHHHHHHHHHHHHHHHHHHHHHHHHHHHHHHHHHHHHHHHHXXXHHHHHHHHHHHHHXXXXXXXXXXXXXXXXXXXXXXXXXXW
WWWWWWWWWWWWWWWWWWWWWWWWWWWWWWWWWWWWWWWWWWWWWWWWWWWWWWWWWWWWWWWWWWWWWWWWWWWWWWWWWWWWWWWWWWWWWWWWWWWWWWWWWWWWWWWWWWWWWWWWWWWWWWWWWWWWWWWWWWWWWWWWWWWWWWWW
