XXXXXXXXXXXXXXXXXXXXXXXXXXXXXXXXXXXXXXXXXXXXXXXXXXXXXXXXXXXXXXXXXXXXXXXXXXXXXXXXXXXXXXXXXXXXXXXXXXXXXXXXXXXXXXXXXXXXXXXXXXXXXXXXXXXXXXXXXXXXXXXXXXXXXXXXXXXXXXXXXXXXXXXXXXXXXXXXXXXXXXXXXXXXXXXXXXXXXXXXXXXX
X----------------------------------------------------------------------------------------------------------------------------------------------------------------------------------------------------------X
X----------------------------------------------------------------------------------------------------------------------------------------------------------------------------------------------------------X
X----------------------------------------------------------------------------------------------------------------------------------------------------------------------------------------------------------X
X----------------------------------------------------------------------------------------------------------------------------------------------------------------------------------------------------------X
X----------------------------------------------------------------------------------E-----------------------------------------------------------------------------------------------------------------------X
X----------------------Q---------------------------------------------------------SSSSSSSS---SSSQ--------------?-----------SSS----SQQS--------------------------------------------------------XX------------X
X-------------------------------------------------------------------------------------------------------------------------------------------------------------------------------------------XXX------------X
X-------------------------------------------------------------------------------E----------------------------------------------------------------------------------------------------------XXXX------------X
X----------------------------------------------------------------S------------------------------------------------------------------------------------------------------------------------XXXXX------------X
X----------------Q---S?SQS---------------------<>---------<>------------------S?S--------------S-----SS----Q--Q--Q-----S----------SS------X--X----------XX--X------------SSQS------------XXXXXX------------X
X--------------------------------------<>------[]---------[]-----------------------------------------------------------------------------XX--XX--------XXX--XX--------------------------XXXXXXX------------X
X----------------------------<>--------[]------[]---------[]----------------------------------------------------------------------------XXX--XXX------XXXX--XXX-----<>--------------<>-XXXXXXXX------------X
X---*-----------------E------[]--------[]-E----[]-----E-E-[]------------------------------------E-E--------E-----------------EE-E-E----XXXX--XXXX----XXXXX--XXXX----[]---------EE---[]XXXXXXXXX--------!---X
XXXXXXXXXXXXXXXXXXXXXXXXXXXXXXXXXXXXXXXXXXXXXXXXXXXXXXXXXXXXXXXXXXXXXXHHXXXXXXXXXXXXXXXHHHXXXXXXXXXXXXXXXXXXXXXXXXXXXXXXXXXXXXXXXXXXXXXXXXXXXXXXXXXXXXXXXXHHXXXXXXXXXXXXXXXXXXXXXXXXXXXXXXXXXXXXXXXXXXXXXXXX
