WWWWWWWWWWWWWWWWWWWWWWWWWWWWWWWWWWWWWWWWWWWWWWWWWWWWWWWWWWWWWWWWWWWWWWWWWWWWWWWWWWWWWWWWWWWWWWWWWWWWWWWWWWWWWWWWWWWWWWWWWWWWWWWWWWWWWWWWWWWWWWWWWWWWWWWWWWWWWWWWWWWWWWWWWWWWWWWWWWWWWWWWWWWWWWWWWWWWWWWWWWWW
W----------------------------------------------------------------------------------------------------------------------------------------------------------------------------------------------------------W
W----------------------------------------------------------------------------------------------------------------------------------------------------------------------------------------------------------W
W----------------------------------------------------------------------------------------------------------------------------------------------------------------------------------------------------------W
W----------------------------------------------------------------------------------------------------------------------------------------------------------------------------------------------------------W
W----------------------------------------------------------------------------------------------------------------------------------------------------------------------------------------------------------W
W----------------------?---------------------------------------------------------XXXXXXXX---XXX?--------------?-----------XXX----X??X--------------------------------------------------------XX------------W
W-------------------------------------------------------------------------------------------------------------------------------------------------------------------------------------------XXX------------W
W------------------------------------------------------------------------------------------------------------------------------------------------------------------------------------------XXXX------------W
W----------------------------------------------------------------X------------------------------------------------------------------------------------------------------------------------XXXXX------------W
W----------------?---X?X?X---------------------XX---------XX------------------X?X--------------X-----XX----?--?--?-----X----------XX------X--X----------XX--X------------XX?X------------XXXXXX------------W
W--------------------------------------XX------XX---------XX-----------------------------------------------------------------------------XX--XX--------XXX--XX--------------------------XXXXXXX------------W
W----------------------------XX--------XX------XX---------XX----------------------------------------------------------------------------XXX--XXX------XXXX--XXX-----XX--------------XX-XXXXXXXX------------W
W---*------------------------XX--------XX------XX---------XX---------------------------------------------------------------------------XXXX--XXXX----XXXXX--XXXX----XX--------------XXXXXXXXXXX--------!---W
WXXXXXXXXXXXXXXXXXXXXXXXXXXXXXXXXXXXXXXXXXXXXXXXXXXXXXXXXXXXXXXXXXXXXX--XXXXXXXXXXXXXXX---XXXXXXXXXXXXXXXXXXXXXXXXXXXXXXXXXXXXXXXXXXXXXXXXXXXXXXXXXXXXXXXX--XXXXXXXXXXXXXXXXXXXXXXXXXXXXXXXXXXXXXXXXXXXXXXXW
WXXXXXXXXXXXXXXXXXXXXXXXXXXXXXXXXXXXXXXXXXXXXXXXXXXXXXXXXXXXXXXXXXXXXXHHXXXXXXXXXXXXXXXHHHXXXXXXXXXXXXXXXXXXXXXXXXXXXXXXXXXXXXXXXXXXXXXXXXXXXXXXXXXXXXXXXXHHXXXXXXXXXXXXXXXXXXXXXXXXXXXXXXXXXXXXXXXXXXXXXXXW
WWWWWWWWWWWWWWWWWWWWWWWWWWWWWWWWWWWWWWWWWWWWWWWWWWWWWWWWWWWWWWWWWWWWWWWWWWWWWWWWWWWWWWWWWWWWWWWWWWWWWWWWWWWWWWWWWWWWWWWWWWWWWWWWWWWWWWWWWWWWWWWWWWWWWWWWWWWWWWWWWWWWWWWWWWWWWWWWWWWWWWWWWWWWWWWWWWWWWWWWWWWW
