WWWWWWWWWWWWWWWWWWWWWWWWWWWWWWWWWWWWWWWWWWWWWWWWWWWWWWWWWWWWWWWWWWWWWWWWWWWWWWWWWWWWWWWWWWWWWWWWWWWWWWWWWWWWWWWWWWWWWWWWWWWWWWWWWWWWWWWWWWWWWWWWWWWWWWWWWWWWWWWW
W--------------------------------------------------------------------------------------------------------------------------------------------------------------W
W--------------------------------------------------------------------------------------------------------------------------------------------------------------W
WX-----XXXXXXXXXXXXXXXXXXXXXXXXXXXXXXXXXXXXXXXXXXXXXXXXXXXXXXXXXXXXXXXXXXXXXXXXXXXXXXXXXXX?XXXXXXXXXXXXXXXXXXXXXXXXXXXXXXXXXXXXXXXXXXXXXXXX--------------------W
WX-----------------------------------------------------XX--XXXXXX--XXXX------XXXX------------------------------------------------------------------------------W
WX-----------------------------------------------------XX--XXXXXX--XXXX------XXXX------------------------------------------------------------XXX-------------!-W
WX---------------------------------------------------XX--------XX---X----XX---------------------------------------------------------------------------------XXXW
WX---------------------------------------------------XX--------XX---X----XX------------------------------------------------------------------------------------W
WX--------------------------------------X-XXXX-X-----XX--------XX---X----XX----------XXXXXX--------------------------------------------------------------------W
WX----------------------------X---------X-X--X-X-----XX--------XX---X-?--XX----------XXXXXX-------------------------------------------------------XXXXX??------W
WX---------?????--------X-X-------------XXX--XXX-----XXXX--XXXXXX---XX---XX--XXXX-----------------------------XX-------------------------XXX-------------------W
WX--------------------X-X-X-X---X----------------------XX-----------------------------------------------XX----XX-----------XX------------XXX-XXX---------------W
WX------------------X-X-X-X-X---X-X--------------------XX-----------------------------------------------XX----XX----XX-----XX----------XXXXX-------------------W
WX---*------------X-X-X-X-X-X---X-X---------------------------------------------------------------------XX----XX----XX-----XX---------XXXXXX-------------------W
WXXXXXXXXXXXXXXXXXXXXXXXXXXXXXXXXXXXXXXXXXXXXXXXXXXXXXXXXXXXXXXXXXXXXXXXXXXXXXXXX---XXXXXXXXXXXXXXXXXXXXXXXXXXXXXXXXXXXXX--XX--XXXXXXXXXXXX-------XXXXXXXX--XXXW
WXXXXXXXXXXXXXXXXXXXXXXXXXXXXXXXXXXXXXXXXXXXXXXXXXXXXXXXXXXXXXXXXXXXXXXXXXXXXXXXXHHHXXXXXXXXXXXXXXXXXXXXXXXXXXXXXXXXXXXXXHHXXHHXXXXXXXXXXXXHHHHHHHXXXXXXXXHHXXXW
WWWWWWWWWWWWWWWWWWWWWWWWWWWWWWWWWWWWWWWWWWWWWWWWWWWWWWWWWWWWWWWWWWWWWWWWWWWWWWWWWWWWWWWWWWWWWWWWWWWWWWWWWWWWWWWWWWWWWWWWWWWWWWWWWWWWWWWWWWWWWWWWWWWWWWWWWWWWWWWW
