WWWWWWWWWWWWWWWWWWWWWWWWWWWWWW
W----------------------------W
W--------------?-------------W
W----------------------------W
W----------------------------W
W----------------------------W
W-----------X?X?X------------W
W----------------------------W
W----------------------------W
W*--------------------------!W
WXXX---XXXXXXXXXXXXXXX--XXXXXW
WXXXHHHXXXXXXXXXXXXXXXHHXXXXXW
WWWWWWWWWWWWWWWWWWWWWWWWWWWWWW
