----------------------------------------------------------------------------------------------------------------------------------------------------------------------------------------
----------------------------------------------------------------------------------------------------------------------------------------------------------------------------------------
----------------------------------------------------------------------------------------------------------------------------------------------------------------------------------------
-------------------------l----------------------------------------------------------------------------------------------------------------------------------------------------------!---
------------------------------------------------------------------------------------------------------------------------------------------------------------------------------------!---
-----------------------------MB---------------------------------------------------------------------------?--------------------------------------------------------------###--------!---
----------------------------------------------------------------------------------#BBB-----------------------------------------------------------------------------------###--------!---
---------------------------------------------------------------------oo----------##----------------------------------------------------------#BB--o----------------------###--------!---
--------------------------------------------------------------------------------###+--------------ooo------------------#BB-M?---------------##------------------------#--###--------!---
---------??-----------------####--BBO------------------ooo-------###------------###------------V----------?-----------##-------------------###--BO-------------------##--###--------!---
-------------------------#####----------------------------------####----------#-###--BBB-------[]--------------------###------------------####----------------------###--###--------!---
----------------------######-----------------------------------#####---------##-###------------pP-------------------####-----------------#####---BBB---------------####--###--------!---
-------------------#######------------------------------------######------------###------------pP------------------#####---BBBBB--------######--------------------#####--###--------#---
#############--#########------##--################--###############---################---###############################-------##-############------#########---#######--###############
