-----------------------------------------------------------------------------------------------------------------------------------------------------------------------------------------------------
-----------------------------------------------------------------------------------------------------------------------------------------------------------------------------------------------------
-----------------------------------------------------------------------------------------------------------------------------------------------------------------------------------------------------
-------------------------------------------------------------------------------------------------------------------------------------------------------------------------------------------------!---
-------------------------------------------------------------------------------------------------------------------------------------------------------------------------------------------------!---
---------------------+BBB---------------------?????-----------*BBB--------BBHBB------BBBB-----------------------------?BBB------------------------------------BBBBB---M--------------------------!---
-------------------------------------------------------------------------------------------------------------------------------------------------------------------------------------------------!---
---------------------------------------------------------------------------------------------------------------------------V---------------------------------------------------------------------!---
-----------------#---------------------V---------------------------V----------------------------V------------------V-------[]----------------------------------------------------------##--------!---
--------BMB----g##---?-----#-----------[]----kM????----------B-----[]---????--???---------------[]-----------------[]--V---pP-----------------------------O---K-----?----V--------BB---##--------!---
---------------###---------#-----------pP--------------------------pP---------------------------pP----------V------pP--[]--pP----------------------#---------------K-----[]------------##--------!---
--------------####---------##----------pP--------------------------pP---------------------------pP----------[]-----pP--pP--pP------------------K---#---------------------pP----------Y-##--------!---
-------------#####----kk---##---gg-----pP-----------gg---k--gg-g---pP-------g-gg-------------g--pP--------g-pP--g--pP--pP--pP----------------------#-----gg--------------pPk---------y-##--------#---
#####################################################################################----##########---##############################---##########--##################################################
