--------------------------
-------------Q------------
--------------------------
--------------------------
--------------------------
-----------S?S?S---Q------
--------------------------
--------------------------
*------------------------!
XXXXXXXXXXXXXXXXXXXXXXXXXX
