WWWWWWWWWWWWWWWWWWWWWWWWWWWWWW
W----------------------------W
W--------------Q-------------W
W----------------------------W
W----------------------------W
W----------------------------W
W-----------S?S?S------------W
W----------------------------W
W----------------------------W
W*--------------------------!W
WXXXXHHXXXXXXXXXXXXXXXHHXXXXXW
WWWWWWWWWWWWWWWWWWWWWWWWWWWWWW
