----------------------------------------------------------------------------------------------------------------------------------------------------------------------------------------------------------------
----------------------------------------------------------------------------------------------------------------------------------------------------------------------------------------------------------------
----------------------------------------------------------------------------------------------------------------------------------------------------------------------------------------------------------------
----------------------------------------------------------------------------------------------------------------------------------------------------------------------------------------------------------------
----------------------------------------------------------------------------------------------------------------------------------------------------------------------------------------------------------------
------------------------------------------------------------------------*-------------------------------------------------------------------------------------------------------------------------##------------
-------------------------------------------------------M-----------------------------------------------------------------B-----------------------------------------oooo--------------------------###------------
------------------------------------------------------------------------------------------------------------------------------------------------------------------------------------------------####------------
-----------------------------------------------------------------------------------------------------------------------------------------------------------------------------------------------#####------------
--------------------------------------------------ooo-------------------?--------------K----------------------------------------------------------------------------V-------------------------######------------
-------------------------------------------------------#------------------------------------------------------------------------------------------------------------[]-----------------------#######------------
-------------------------------------------------------#--------------#---#----------------------------------------------#------------------------------------------pP----------------------########--------!---
-S--------k-------g-gg-----k-k-------k-k----#----------#----k--gg-g---#-k-#-----------------------------k-------gg-g-----#-----k------kk-k-------k---------k-kk-----pP------g-gg-----gg----#########--------#---
###########################################################################--#########################################--###--###################################################################################
