WWWWWWWWWWWWWWWWWWWWWWW
W---------------------W
W---------------------W
W---------------------W
W-------?-----------!-W
W-----------XXXX---XXXW
W-*---------------XXXXW
WXXX---XXX--------XXXXW
WXXXHHHXXXHHHHHHHHXXXXW
WWWWWWWWWWWWWWWWWWWWWWW
