WWWWWWWWWWWWWWWWWW
|############----|
|################|
|####----------##|
|####----------##|
|#--------------#|
|#-------------!#|
|#-----##########|
|#-----##########|
|####-----####---|
|####-----####---|
|####--------####|
|####-T------####|
|#-----------D###|
|#-----------D###|
|#---T--#########|
|#--------------#|
|#--------------#|
|#########------#|
|####------------|
|#--------T------|
|----------------|
|----------------|
|----########----|
|-----------#----|
|-----------#----|
|##----------####|
|##--------------|
|##--------------|
|####MMMMMMMMMMMM|
|####------------|
|####------------|
|####----#-------|
|--------#-------|
|--------#-------|
|--------#-T-----|
|----------------|
|----------------|
|MMMMMMMM#MMMMMMM|
|----------------|
|----------------|
|####----------##|
|####----------##|
|####----------##|
|####------######|
|----------------|
|----------------|
|MMMMMMMMMMMMMMMM|
|----------------|
|-#--------------|
|##----------####|
|##--------------|
|##--------------|
|##MMMMMMMMMMMMMM|
|----------##----|
|----------##----|
|--TTTT----------|
|----------------|
|----------------|
|MMMMMMMMMMMM#MMM|
|----------------|
|----------------|
|MMMMMMMM#MMMMMMM|
|----------------|
|----------------|
|####MMMMMMMMMM##|
|#-------------##|
|#-------------##|
|#MMMMMMMMMMMMM##|
|##--------------|
|##--------------|
|####--------####|
|####--------####|
|#######-----####|
|####------T-####|
|##----------####|
|##----------####|
|##----TT########|
|##--------------|
|##--------------|
|##TTTT----------|
|##--------------|
|----------------|
|-----TTTT-------|
|----------------|
|----------------|
|--------TTTT----|
|----------------|
|--------------T-|
|----------------|
|----------------|
|-----#---#---#--|
|--#--#---#---#--|
|--#--#---#---#--|
|--#--#---#---#--|
|--#-T-----------|
|----------------|
|----------------|
|----TTTTT-------|
|----------------|
|----------------|
|------TTTT------|
|----------------|
|---TTTT---------|
|----------------|
|----------------|
|TTTT------TTTTTT|
|#---------------|
|#---------------|
|#------TTTT-----|
|#---------------|
|##--------------|
|#D--TTTT--------|
|#D--------------|
|#TTTT-----------|
|----------------|
|---TTTT---------|
|----------------|
|------TTTT------|
|----------------|
|---------TTTT---|
|----------------|
|####--------TTTT|
|----------------|
|---TTTT---------|
|----------------|
|------####------|
|----------------|
|---------TTTT---|
|----------------|
|----------------|
|#TTTTTTTT----###|
|#------------###|
|#------------###|
|#--T---------###|
|----------------|
|----------------|
|-T--------------|
|----------------|
|----T---##------|
|--------#D------|
|--------#D------|
|--------#####---|
|TTTT--------####|
|----------------|
|----------------|
|---######-------|
|----------------|
|--------TTTT----|
|----------------|
|TTTTTTTT----TTTT|
|----------------|
|----------------|
|-----TTTT-------|
|----------------|
|----T----TTTT---|
|----------------|
|----------------|
|--TTTT-----TTTT-|
|--------D-------|
|--------D-------|
|------TTTT------|
|----------------|
|----------------|
|--TTTT----TTTT--|
|----------------|
|----------------|
|TTTT-------TTTTT|
|----------------|
|----------------|
|---TTTT---------|
|----------------|
|----------------|
|##-----TTTT---##|
|##------------##|
|##------------##|
|######----######|
|##------------##|
|##------------##|
|#-----TTTT-----#|
|---------TTTT---|
|----------------|
|----------------|
|#D-----------T##|
|#D------------##|
|##TTT####-----##|
|##------------##|
|----------------|
|---------TTTT---|
|----------------|
|----------------|
|##------TTTTTT##|
|##------------##|
|##------------##|
|####----------##|
|####-----------#|
|####-----------#|
|############---#|
|###########----#|
|####----------##|
|#--------------#|
|#*-------------#|
|#####---########|
|################|
WWWWWWWWWWWWWWWWWW