WWWWWWWWWWWWWWWW
WX------------XW
WX-----------!XW
WX------XXXXXXXW
WX---TTT------XW
|--------------|
WXXXX------TTTXW
WX------------XW
WX*-----------XW
WXXXXXXXXXXXXXXW
WWWWWWWWWWWWWWWW
