WWWWWWWWWWWWWWWW
W#------------#W
W#----------!-#W
W#------#######W
W#---TTT------#W
|--------------|
W####------TTT#W
W#------------#W
W#*-----------#W
W##############W
WWWWWWWWWWWWWWWW