----------------------------
-------------------------!--
--###---##-----#####----###-
*---------------------------
#####----###-------##--#####
