WWWWWWWWWWW
W----!----W
W--?????--W
W*--------W
WXXXXXXXXXW
WWWWWWWWWWW
