--------------------------------------------
--------------------------------------------
--------------------------------------------
--------------------------------------------
--------------------------------------------
-------g------------------------------------
---BBBBBBBB---BBB?--------------------------
----------------------[]---------[]---------
----------------------pP---------pP---------
----------------------pP---------pP---------
----------------------pP---gg----pP----!----
############################################
