WWWWWWWWWWWWW
W-----!-----W
W--???????--W
W*----------W
WXXXXXXXXXXXW
WWWWWWWWWWWWW
