-----------------------------------------------
-----------------------------------------------
-----------------------------------------------
-----------------------------------------------
-------------------------------------------!---
-----###-------##---------#####----------###---
*----------------------------------------------
#####--------###-----------##------#####-------
