-----------------------------------------------
-----------------------------------------------
-----------------------------------------------
-----------------------------------------------
-------------------------------------------!---
-----###-------##---------#####----------###---
S----------------------------------------------
#####--------###-----------##------#####-------
