WWWWWWWWWWWWWWWWW
W-------!-------W
W----???????----W
W*--------------W
WXXXXXXXXXXXXXXXW
WWWWWWWWWWWWWWWWW
