----------------------------
-------------------------!--
--###---##-----#####----###-
S---------------------------
#####----###-------##--#####
