##!---#####
#?##----#?#
#S##--###-#
#---------#
###-###---#
###-####--#
#?--##---?#
###----##?#
#---??----#
