#########
#!----#-#
####-##-#
#S------#
###-#####
#-------#
#########
